1111111111111111
0010000101111111
1010101101111111
1000111100001111
1010000001111111
1011111100111111
1011111110011111
1111111111011111
1111000000000001
1111111101110111
1000000101000111
1111011101101111
1111111111101111